111111111111111111111111111111111111
1000000000000000000000001000000000E1
1000000000000000011110C010C010001111
100000C11111110000000000111110001C01
100111110000000000010000001000001001
100000C10000001100011110001000000001
11111111000100010C01C0000000C0011111
100000010001000111110000111000010C01
1P00000100010000000000000C1000000001
111111111111111111111111111111111111