111111111111111111111111111111111111
1000000000000000000000001000000000E1
100000000000000001111000100010001111
100000011111110000000000111110001001
100111110000000000010000001000001001
100000010000001100011110001000000001
111111110001000100010000000000011111
100000000001000111110000111000010001
1P0000000001000000000000001000000001
111111111111111111111111111111111111