111111111111
100C00E00001
100000000001
100000000001
100000000001
100000000001
100000000001
1P0000000001
111111111111