11111111111111
100C00E0000001
10000000000001
10000000000001
10000000000001
10000000000001
10000000000001
1P000000000001
11111111111111