1111111111111
100C000E00001
1000000000001
1000000000001
1000000000001
1000000000001
1000000000001
1P00000000001
1111111111111