111111111111111111111111111111111111
100000000000000000000000100000C000E1
100000000000000001111010101010001111
100000111111110000000000111110001101
100111110000000000010000001000001001
100000110000001100011110001000000001
111111110001000101011000000010011111
100000000001000111110000111000010101
1P0000000001000000000000011000000001
111111111111111111111111111111111111